1111111111111111111111111111111111111111
1C10000000011110000000000C1C000010000001
10100000011111111100000001EC000000000C01
1011000000000000000000000C11001111100001
1010010000110000000000000C00000000000001
1000010000000000000000111111000000000001
1111111111111100000000000000000000000001
1000000000000001111111100000000001111101
10011111000000000000001111111111110CC001
1C000000000000000000000000000000000CC001
1000001111111111110000000000000000000001
1000000000000000000000011111111110000001
1000000000011111100000000000000000000001
100C0000000000000100P0000111000000000011
1011111111110000000000000001111111111111
1111111111111111111111111111111111111111
