111111111111111111111111111111
1C10000000011110000000000C0001
10100000101111111101000001E101
101100001000000001000010011101
101001001011000100010000011111
100001000000000000000011111111
111111110111111000000000000111
110000000000000111101110000111
110111110000000000000011111111
1C00000000000000000000000CC001
100000111111111111000000000011
100000000000000000000001111101
100000000001111110011110000001
100C0000000000000100P000011111
111111111111111111111111111111
