1111111111111
100P00C00C001
1000011111E01
1001110C01111
1101111101111
100000C00C001
1000011111001
1000110C01111
1110111101111
100000C00C001
1000010011001
1000010C01111
1110011111111
100000C00C001
1000010111001
1001000C01011
1110000011011
100C00C00C001
1000011100001
1001001C01111
1111111111111
